6,7,7,7,7,7,7,7,7,7,7,7,7,3,
9,1,2,1,2,1,1,1,0,0,1,0,21,10,
9,0,0,0,0,0,0,2,0,0,2,0,0,10,
9,1,0,0,0,0,0,2,0,0,1,2,1,10,
9,2,2,2,1,1,1,1,0,0,0,0,0,10,
9,0,0,0,1,0,0,0,0,0,0,0,0,10,
9,0,20,0,2,0,0,22,0,0,2,2,1,10,
9,0,0,0,1,0,0,0,0,2,2,0,0,10,
9,1,2,2,1,1,2,1,2,1,0,0,0,10,
9,0,0,0,0,1,2,1,2,1,0,22,0,10,
9,1,2,2,2,1,2,1,2,1,0,0,0,10,
9,0,23,0,0,0,0,0,0,0,0,0,2,10,
9,0,0,0,0,0,0,0,0,0,0,2,1,10,
5,8,8,8,8,8,8,8,8,8,8,8,8,4