4,4,4,4,4,4,4,4,4,4,4,4,4,4,
0,2,0,0,0,0,0,0,0,0,0,2,0,0,
0,3,0,0,2,0,0,3,2,2,0,0,3,2,
0,2,0,3,0,2,0,0,0,2,2,0,21,0,
0,0,0,0,2,2,2,2,0,0,0,3,2,2,
0,0,0,0,3,0,0,0,0,0,0,0,0,0,
4,4,4,4,4,4,1,4,4,4,4,4,4,4,
0,0,2,0,0,0,0,0,0,0,0,0,3,2,
0,20,3,0,0,0,0,2,0,3,2,2,2,0,
0,0,2,0,0,0,0,22,0,2,0,0,0,0,
4,4,4,4,4,4,4,4,4,1,4,4,4,4,
0,0,2,2,0,0,0,0,0,0,0,2,2,2,
0,20,0,2,3,3,0,0,0,0,0,3,0,0,
0,0,0,0,0,0,2,0,23,0,0,3,0,0