4,4,4,4,4,4,4,4,4,4,4,4,4,4,
0,2,0,0,0,0,20,0,0,0,0,2,0,0,
0,3,0,0,2,0,0,3,2,2,0,0,3,2,
0,2,0,3,0,2,0,0,0,2,2,0,0,0,
0,0,0,0,2,2,2,2,0,0,0,3,2,2,
0,0,0,0,3,0,0,0,0,0,0,0,0,0,
4,4,4,4,4,4,1,4,4,4,4,4,4,4,
0,0,2,0,0,0,0,0,0,0,0,0,3,2,
0,0,3,0,0,0,0,2,0,3,2,2,2,0,
0,0,2,0,0,22,0,0,0,2,0,22,0,0,
4,4,4,4,4,4,4,4,4,1,4,4,4,4,
0,0,2,2,0,0,0,0,0,0,0,2,2,2,
0,0,20,2,3,3,0,0,0,0,0,3,0,0,
0,0,0,0,0,0,2,0,20,0,0,3,0,0